99999999999999999999999999999999999999999999999999999999999999
92111111111111111111111111111111111111111111111111111111111129
91000000000000000000000000000000000000000000000000000000000019
91000000000000000000000000000000000000000000000000000000000019
91000000000000000000000000000000000000000000000000000000000019
91000100000000000000000000000000000000000000000000000000100019
91000100000000000000000000000000000000000000000000000000100019
91000100000000000000000000000000000000000000000000000000100019
91000100000000000000000000000000000000000000000000000000100019
91000100000000000000000000000000000000000000000000000000100019
91000100000000000000000000000000000000000000000000000000100019
91000100000000000000000000000000000000000000000000000000100019
91000111111111110000000000000010000000000000011111111111100019
91000000000000010000000000000010000000000000010000000000000019
91000000000000010000000000000010000000000000010000000000000019
91000000000000010000000000011121110000000000010000000000000019
91000000000000010000000000000010000000000000010000000000000019
91000000000000010000000000000010000000000000010000000000000019
91000111111111110000000000000010000000000000010000000000000019
91000100000000000000000000000000000000000000011111111111100019
91000100000000000000000000000000000000000000000000000000100019
91000100000000000000000000000000000000000000000000000000100019
91000100000000000000000000000000000000000000000000000000100019
91000100000000000000000000000000000000000000000000000000100019
91000100000000000000000000000000000000000000000000000000100019
91000100000000000000000000000000000000000000000000000000100019
91000100000000000000000000000000000000000000000000000000100019
91000000000000000000000000000000000000000000000000000000000019
91000000000000000000000000000000000000000000000000000000000019
91000000000000000000000000000000000000000000000000000000000019
92111111111111111111111111111111111111111111111111111111111129
99999999999999999999999999999999999999999999999999999999999999
